111111111111111111111111
111111C00000000C00111111
111111C11E11111110111111
111111C0001111111P111111
111111111111111111111111