111111
10E011
1CC001
111111
1PCV01
100111
111111