11111111111111111111
1000000000000000C001
1000P000000000011111
10000000000C0001E001
11111111111111111111