1111111111
10000E1001
1P000000P1
10000000C1
1111111111
