111111111111
1EPC11111111
111111111111
111111111111