111111111111111111111111111111
1EP0C1111111111111111111111111
111111111111111111111111111111
111111111111111111111111111111