

11111111111111111111
101P0000000000000011
100000001110000C0011
111110001C0000E00011
1000C000000000000011
11111111111111111111