111111
10E011
1CC001
11P111
10C001
100111
111111