111111
10E011
1CC001
11P111
10CV01
100111
111111