
111111111
10EP11111
100001111
100011111
100001111
11C011111
111111111
