1111111111111
11EPC11111111
1111111111111
1111111111111